1,6,6,6,6,1,6,6,6,6,1
1,6,6,6,6,1,6,6,6,6,1
1,6,6,6,6,1,6,6,6,6,1
1,6,6,6,6,1,6,6,6,6,1
1,6,6,6,6,1,6,6,6,6,1
1,6,6,6,6,1,6,6,6,6,1
1,1,1,1,1,1,1,1,1,1,1
6,6,6,6,6,1,6,6,6,6,6
6,6,6,6,6,1,6,6,6,6,6
6,6,6,6,6,1,6,6,6,6,6
6,6,6,6,5,1,5,6,6,6,6
