1,1,1,1,3,1,3,1,1,1,1
1,1,1,1,3,1,3,1,1,1,1
1,1,1,1,3,1,3,1,1,1,1
1,1,6,1,1,1,1,1,6,1,1
1,6,5,6,1,1,1,6,5,6,1
6,6,6,6,6,1,6,6,6,6,6
1,1,1,1,1,1,1,1,1,1,1
1,5,5,5,5,5,5,5,5,5,1
1,5,5,5,5,5,5,5,5,5,1
1,1,1,1,1,1,1,1,1,1,1
5,5,5,5,1,3,1,5,5,5,5
