3,3,3,3,3,3,3,3,3,3,3
3,3,1,1,3,1,3,1,1,3,3
3,1,1,1,3,1,3,1,1,1,3
3,1,1,1,1,1,1,1,1,1,3
3,1,1,1,1,1,1,1,1,1,3
3,1,1,1,1,1,1,1,1,1,3
3,3,3,3,3,1,3,3,3,3,3
3,7,3,7,3,1,3,7,3,7,3
7,7,7,7,3,1,3,7,7,7,7
7,7,7,7,3,1,3,7,7,7,7
7,7,7,7,3,1,3,7,7,7,7
