0,0,0,0,0,0,0,403,0,421,206
0,0,0,0,415,0,0,409,403,0,0
207,201,0,0,0,420,0,0,0,0,0
201,424,0,417,0,420,0,406,0,0,0
424,417,302,406,0,420,0,406,0,0,0
0,0,0,406,0,0,0,0,0,0,702
0,701,0,0,0,213,0,212,0,0,0
206,206,0,0,0,201,0,201,0,701,0
406,406,0,301,0,424,0,424,0,0,0
0,0,409,408,409,0,418,0,0,0,0
0,0,0,0,0,0,0,0,301,417,0
