0,417,415,0,0,0,404,0,0,206,207
0,0,0,0,0,0,0,302,0,406,406
0,0,207,417,0,0,0,0,0,0,0
406,0,202,417,0,424,302,0,0,0,0
212,0,417,0,0,0,0,0,301,424,417
0,0,0,0,0,0,0,0,0,502,206
0,701,417,0,0,0,0,0,0,0,0
0,0,0,301,0,0,0,420,0,0,0
216,0,0,415,0,0,0,0,0,0,0
217,0,404,0,0,404,0,702,0,424,0
202,420,424,0,0,0,417,0,424,0,0
