213,0,0,0,0,701,0,0,0,0,212
206,407,0,0,0,406,407,407,0,407,206
201,0,0,407,407,304,0,0,0,0,201
0,0,0,0,0,304,0,0,0,0,0
0,0,0,0,0,0,0,0,0,0,0
0,0,0,0,0,0,0,0,0,0,0
406,0,406,0,0,0,0,406,405,0,0
304,0,304,0,0,304,0,0,304,0,304
407,0,407,0,0,405,0,0,407,407,407
0,0,0,0,0,0,0,0,0,407,0
201,202,201,0,0,702,0,0,0,203,0
