202,201,412,0,0,702,0,0,201,412,0
0,0,0,411,0,411,0,0,0,0,411
0,0,0,0,0,304,0,0,0,0,0
0,0,0,304,0,411,0,0,304,0,0
0,0,0,0,0,213,0,0,0,0,0
0,304,0,0,0,0,0,0,0,304,0
206,0,0,201,0,0,0,201,0,0,207
0,0,304,0,0,212,0,0,304,0,0
0,0,0,0,0,304,0,0,0,0,0
0,0,0,0,0,412,0,0,0,0,0
0,0,304,0,0,701,0,0,304,0,0
