701,0,0,203,0,702,0,702,0,410,404
0,213,425,0,0,0,0,0,0,0,410
0,0,0,0,0,0,0,212,701,0,0
0,0,0,425,0,404,0,213,0,0,0
0,424,0,0,0,416,0,0,302,0,0
404,418,404,302,0,404,0,0,0,0,0
0,0,0,407,0,0,0,0,0,0,0
0,410,0,0,0,0,0,410,0,0,301
0,0,0,0,0,0,302,424,410,0,0
226,0,417,0,0,0,0,0,0,0,407
407,407,0,416,0,302,424,416,424,0,0
