222,0,701,0,0,702,0,408,0,0,0
0,417,0,0,0,0,0,0,0,0,0
203,415,0,0,0,0,0,0,0,414,0
0,0,0,301,0,202,0,0,0,0,0
0,406,0,0,0,201,0,403,0,0,405
0,0,0,0,0,0,0,0,0,301,0
0,418,301,0,0,207,0,0,0,0,0
0,0,0,0,0,213,0,0,0,0,0
0,0,0,0,0,0,405,0,0,0,408
0,409,0,0,0,0,0,0,0,0,0
0,213,0,0,0,403,0,701,0,0,206
