0,0,0,0,0,0,0,0,0,0,0
0,701,0,405,0,0,0,408,302,212,0
0,0,0,0,0,402,0,0,0,216,0
0,405,0,0,402,405,0,0,0,217,0
0,0,0,0,0,0,0,0,0,0,0
701,0,0,405,0,0,302,0,0,0,0
0,0,0,0,0,0,0,0,0,301,0
0,0,601,602,603,0,0,0,0,414,0
0,701,401,402,0,0,402,0,0,0,0
0,0,207,0,0,0,0,702,0,702,0
0,0,0,0,0,0,0,0,0,0,0
