0,421,0,0,0,420,406,0,0,417,201
0,418,0,0,301,0,0,0,0,0,0
0,403,0,0,0,0,0,0,0,0,417
0,0,0,213,0,0,0,212,0,0,415
0,0,0,213,0,416,0,212,0,0,0
702,0,0,201,302,423,302,201,0,0,701
0,0,0,207,0,416,0,206,0,0,0
0,0,0,207,0,0,0,206,0,501,207
406,406,0,0,0,301,0,0,0,213,212
0,0,0,420,0,0,0,408,0,409,409
0,0,0,420,0,0,0,408,0,0,0
