207,0,202,0,0,701,0,0,502,203,213
212,0,201,0,491,492,493,0,0,0,0
0,0,201,0,494,495,496,0,424,416,424
417,0,0,0,497,498,499,0,0,301,0
0,302,0,0,0,0,0,0,404,407,0
0,0,0,0,0,303,0,0,0,404,0
416,0,0,0,0,410,0,0,0,0,0
0,0,404,0,0,0,301,0,0,0,0
417,0,407,404,0,0,0,0,0,0,0
0,0,201,0,0,0,0,0,0,0,0
206,0,0,0,0,702,0,0,213,701,0
