213,0,0,0,0,701,0,0,0,0,212
404,0,0,0,0,0,0,0,0,0,404
0,0,0,0,0,404,0,0,0,0,0
0,0,0,0,0,0,0,0,0,0,0
303,0,0,0,0,303,0,0,0,0,303
403,0,0,0,0,403,0,0,0,0,403
0,0,402,402,0,0,0,0,402,402,0
0,0,0,0,0,301,0,0,0,0,0
0,0,0,0,0,401,0,0,0,0,0
0,0,0,0,0,0,0,0,0,0,0
0,0,0,0,0,704,0,0,0,0,0
