0,0,0,0,0,0,0,0,0,0,0
0,702,0,0,0,0,403,402,0,0,0
0,0,0,301,0,0,402,408,0,0,0
0,207,0,414,0,0,502,218,0,0,0
0,0,0,0,0,0,0,0,0,0,0
702,0,408,221,0,701,402,403,0,408,0
0,0,0,0,0,0,0,0,0,0,0
0,0,202,0,0,0,0,0,0,201,0
0,702,0,0,0,0,0,0,302,414,0
0,0,401,402,401,0,0,0,0,202,0
0,0,0,0,0,0,0,0,0,0,0
