702,0,0,0,501,0,0,0,0,0,0
0,0,0,0,0,0,0,0,0,0,0
0,0,0,0,0,0,0,0,0,0,0
0,0,0,0,0,0,0,0,0,0,0
0,0,0,0,0,0,0,0,0,0,0
0,0,0,0,0,0,0,0,0,0,0
0,0,0,0,0,0,0,0,0,0,0
0,302,0,0,0,0,0,0,0,302,0
410,416,410,0,0,0,0,0,407,424,407
213,410,213,0,425,0,425,0,212,407,212
207,227,207,0,701,0,701,0,206,203,206
