0,0,417,424,417,0,0,0,0,404,0
0,0,0,0,0,0,0,0,0,417,424
0,0,213,206,404,205,0,201,201,0,302
212,0,0,0,0,404,0,420,420,0,417
0,0,0,0,0,304,0,0,0,0,0
0,0,0,0,421,421,0,0,0,0,415
417,0,301,0,0,0,0,0,0,0,303
0,0,0,418,407,204,0,224,305,407,407
0,0,0,0,0,0,0,0,0,407,407
0,0,409,406,0,702,0,701,0,202,203
0,0,409,0,0,0,0,0,0,0,0
