0,0,0,0,0,0,0,0,0,0,0
0,213,212,0,0,0,0,702,0,0,0
0,206,206,0,0,0,0,0,0,0,0
0,0,0,0,0,304,0,0,0,0,0
0,0,303,0,0,0,0,0,0,0,0
0,0,0,0,303,0,202,0,0,0,0
0,301,0,301,0,0,0,0,0,0,0
0,0,0,213,0,0,0,0,0,0,0
0,203,0,212,0,201,0,0,0,0,0
0,203,0,0,202,0,0,701,0,701,0
0,0,0,0,0,0,0,0,0,0,0
