702,0,303,0,0,701,0,701,0,0,0
0,0,0,0,0,404,0,0,0,702,0
0,0,0,0,424,0,0,410,0,0,0
216,217,0,0,0,702,0,416,0,0,0
0,0,0,0,0,0,0,410,0,201,203
0,407,304,424,0,0,0,0,0,416,407
206,206,0,425,424,202,0,0,0,425,424
0,0,0,0,301,0,0,0,0,206,207
0,413,0,0,205,206,0,0,0,0,0
0,0,0,0,0,0,0,0,0,0,0
0,0,0,419,419,225,0,404,424,404,0
