0,0,0,0,0,0,0,0,0,0,0
0,501,0,0,0,702,0,701,0,0,0
0,0,0,0,0,0,0,0,0,0,0
0,0,0,0,0,0,0,0,0,0,0
0,0,0,0,0,0,0,0,0,0,0
0,0,0,0,0,0,0,0,0,0,0
0,0,0,0,0,0,301,0,0,0,0
0,0,0,0,0,0,0,0,0,301,0
0,206,0,206,0,0,0,502,0,0,0
0,213,201,212,0,0,0,203,201,201,0
0,0,0,0,0,0,0,0,0,0,0
