0,0,0,0,0,0,0,0,0,0,0
0,0,305,0,0,701,0,0,502,0,0
0,491,492,493,0,0,0,0,302,401,0
0,494,495,496,0,0,0,0,303,0,0
0,497,498,499,0,0,0,0,305,0,0
0,0,0,0,0,0,0,0,0,0,0
0,0,0,0,0,304,0,0,0,0,0
0,0,0,0,0,0,0,0,0,0,0
0,0,0,0,0,0,0,0,0,0,0
0,0,0,0,0,801,0,0,0,0,0
0,0,0,0,0,0,0,0,0,0,0
