0,0,0,0,701,0,0,0,0,0,701
0,0,0,0,424,0,0,0,201,202,203
0,0,0,0,403,0,0,0,0,0,0
0,0,0,0,409,0,0,217,415,216,0
0,0,0,0,420,0,0,0,0,0,206
0,0,0,415,417,0,0,212,417,206,0
0,702,0,301,0,0,0,0,0,0,0
418,418,0,211,201,0,0,213,0,702,418
418,0,0,0,406,0,0,0,0,0,424
421,421,0,406,406,0,0,0,304,217,216
0,0,0,0,0,0,0,0,0,0,0
