701,0,0,0,0,702,0,0,201,409,0
0,0,304,0,0,0,0,0,0,701,0
0,0,0,0,0,0,0,0,409,0,416
202,416,424,0,213,701,212,0,404,0,410
0,0,410,0,424,410,424,0,0,0,0
0,0,0,0,0,0,0,0,0,0,0
0,0,0,0,0,301,0,0,0,0,404
407,0,0,0,0,0,0,0,0,0,417
0,0,0,0,0,0,0,0,206,0,0
0,0,0,0,0,0,0,0,0,0,0
0,404,0,0,417,424,0,0,0,702,0
