0,0,408,0,0,702,0,0,408,0,0
0,0,0,0,0,0,0,0,0,0,0
0,0,206,212,0,410,304,408,201,0,0
0,0,0,410,0,0,0,0,216,0,0
408,0,0,304,0,303,0,0,0,0,408
409,0,0,0,0,0,0,0,0,0,409
408,0,0,0,0,301,0,0,0,0,408
0,0,0,410,304,409,0,203,217,0,0
0,0,207,213,0,0,0,410,0,0,0
0,0,0,0,0,0,0,304,0,0,0
0,0,410,0,0,701,0,0,410,0,0
