0,501,0,0,201,206,0,0,301,0,0
409,0,0,0,0,0,0,420,0,416,417
0,0,0,0,0,0,0,420,0,201,218
409,0,416,0,0,424,301,0,0,0,0
0,0,0,0,0,0,0,417,302,417,0
0,0,302,0,404,0,0,0,0,206,0
0,702,418,301,0,0,0,301,0,404,0
0,0,302,0,404,0,301,421,0,0,0
212,417,0,0,0,0,0,0,0,0,0
0,424,0,0,0,0,424,415,0,0,0
0,213,0,0,0,701,0,416,0,0,0
