0,0,0,0,0,0,0,0,0,0,0
0,501,401,0,0,702,0,701,0,0,0
0,0,402,0,0,0,0,0,405,0,0
0,0,0,0,0,0,0,401,402,401,0
0,405,0,0,0,0,405,0,0,0,0
0,0,0,0,0,0,0,0,0,0,0
0,0,302,0,0,0,301,0,0,414,0
0,401,0,401,0,0,0,0,0,301,0
0,206,417,206,0,0,0,502,0,0,0
0,213,201,212,0,401,0,203,201,201,0
0,0,0,0,0,0,0,0,0,0,0
