0,0,415,0,702,0,409,420,409,0,702
0,0,406,0,0,0,0,0,0,0,0
0,0,0,0,420,0,0,0,0,0,0
218,0,303,0,418,0,0,415,417,0,409
213,0,425,0,0,0,0,417,0,0,0
212,0,0,0,303,0,0,301,0,0,0
223,0,416,0,0,0,0,301,0,0,424
206,0,410,0,0,0,0,301,0,0,302
207,0,410,0,0,0,0,205,0,0,302
419,0,0,0,406,701,424,421,424,0,0
0,0,0,0,0,0,0,0,0,0,0
