0,0,702,0,201,201,0,0,0,0,0
0,421,303,0,201,415,0,0,0,0,0
201,0,0,0,0,301,0,421,0,406,0
0,414,418,0,0,202,0,301,0,418,0
0,409,0,201,0,0,0,0,0,0,0
701,0,0,0,0,0,0,409,0,0,0
0,414,408,0,301,405,0,206,0,0,0
0,206,0,206,0,405,0,207,0,414,0
0,0,0,0,0,0,0,0,0,0,0
0,611,612,613,0,0,0,0,0,301,0
0,212,0,213,302,414,0,702,0,0,0
