0,216,217,206,0,701,0,502,0,201,202
0,405,406,405,0,402,0,0,0,0,0
0,0,0,0,0,403,0,0,0,0,0
0,0,403,0,0,402,0,0,0,0,206
0,0,304,0,0,0,0,0,405,0,0
0,0,408,414,0,702,0,0,0,403,301
0,0,301,0,0,0,0,0,302,0,301
0,0,0,0,0,0,0,0,405,0,0
0,213,203,212,0,0,0,0,414,414,414
0,0,211,0,0,0,0,0,0,0,0
0,0,0,0,0,501,0,0,0,206,201
